00000000000000
04444332222210
04443322222110
04433222221110
04332222211110
03322222111110
03222221111110
02222221111110
02222111111110
02221111111110
02221111111110
02111111111110
01111111111110
01111111111110
00000000000000