{
  "levels": [
    {
      "id": 1,
      "name": "The Beginning",
      "description": "A tutorial level to introduce players to the game mechanics.",
      "difficulty": "Easy",
      "layout": [
        "00000000000000",
        "04444332222210",
        "04443322222110",
        "04433222221110",
        "04332222211110",
        "03322222111110",
        "03222221111110",
        "02222211111110",
        "02222111111110",
        "02221111111110",
        "02211111111110",
        "02111111111110",
        "01111111111110",
        "01111111111110",
        "00000000000000"
      ]
    },
    {
      "id": 2,
      "name": "The Forest",
      "description": "A dense forest level filled with challenges and resources.",
      "difficulty": "Medium",
      "layout": [
        "00000000000000",
        "00000000000000",
        "00000000000000",
        "00000000000000",
        "00000000000000",
        "00000000000000",
        "00000000000000",
        "00000000000000",
        "00000000000000",
        "00000000000000",
        "00000000000000",
        "00000000000000",
        "00000000000000",
        "00000000000000",
        "00000000000000"
      ]
    }
  ]
}